XXXXXXXXXXXXXXXXXXXXXXXXXXXXXXXXXXXXXXXXXXXXXXXXXXXXXXXXXXXXXXXXXXXXXXXXXXXXXXXXXXXXXXX
VVVVVVVVVVVVVVVVVVVVVVVVVVVVVV<AAAAAAAAAAAAAAAAAAAAAAAAA>WWWWWWWWWWWWWWWWWWWWWWWWWWWWWW
VVVVVVVVVVVVVVVVVVVVVVVVVVVVVV<AAAAAAAAAAAAAAAAAAAAAAAAA>WWWWWWWWWWWWWWWWWWWWWWWWWWWWWW
VVVVVVVVVVVVVVVVVVVVVVVVVVVVVV<AAAAAAAAAAAAAAAAAAAAAAAAA>WWWWWWWWWWWWWWWWWWWWWWWWWWWWWW
VVVVVVVVVVVVVVVVVVVVVVVVVVVVVV<AAAAAAAAAAAAAAAAAAAAAAAAA>WWWWWWWWWWWWWWWWWWWWWWWWWWWWWW
VVVVVVVVVVVVVVVVVVVVVVVVVVVVVV<AAAAAAAAAAAAAAAAAAAAAAAAA>WWWWWWWWWWWWWWWWWWWWWWWWWWWWWW
VVVVVVVVVVVVVVVVVVVVVVVVVVVVVV<AAAAAAAAAAAAAAAAAAAAAAAAA>WWWWWWWWWWWWWWWWWWWWWWWWWWWWWW
VVVVVVVVVVVVVVVVVVVVVVVVVVVVVV<AAAAAAAAAAAAAAAAAAAAAAAAA>WWWWWWWWWWWWWWWWWWWWWWWWWWWWWW
VVVVVVVVVVVVVVVVVVVVVVVVVVVVVV<AAAAAAAAAAAAAAAAAAAAAAAAA>WWWWWWWWWWWWWWWWWWWWWWWWWWWWWW
VVVVVVVVVVVVVVVVVVVVVVVVVVVVVV<AAAAAAAAAAAAAAAAAAAAAAAAA>WWWWWWWWWWWWWWWWWWWWWWWWWWWWWW
VVVVVVVVVVVVVVVVVVVVVVVVVVVVVV<AAAAAAAAAAAAAAAAAAAAAAAAA>WWWWWWWWWWWWWWWWWWWWWWWWWWWWWW
VVVVVVVVVVVVVVVVVVVVVVVVVVVVVV<AAAAAAAAAAAAAAAAAAAAAAAAA>WWWWWWWWWWWWWWWWWWWWWWWWWWWWWW
VVVVVVVVVVVVVVVVVVVVVVVVVVVVVV<AAAAAAAAAAAAAAAAAAAAAAAAA>WWWWWWWWWWWWWWWWWWWWWWWWWWWWWW
VVVVVVVVVVVVVVVVVVVVVVVVVVVVVV<AAAAAAAAAAAAAAAAAAAAAAAAA>WWWWWWWWWWWWWWWWWWWWWWWWWWWWWW
VVVVVVVVVVVVVVVVVVVVVVVVVVVVVV<AAAAAAAAAAAAAAAAAAAAAAAAA>WWWWWWWWWWWWWWWWWWWWWWWWWWWWWW
VVVVVVVVVVVVVVVVVVVVVVVVVVVVVV<AAAAAAAAAAAAAAAAAAAAAAAAA>WWWWWWWWWWWWWWWWWWWWWWWWWWWWWW
VVVVVVVVVVVVVVVVVVVVVVVVVVVVVV<AAAAAAAAAAAAAAAAAAAAAAAAA>WWWWWWWWWWWWWWWWWWWWWWWWWWWWWW
VVVVVVVVVVVVVVVVVVVVVVVVVVVVVV<TTTTTTTTTTTTTTTTTTTTTTTTT>WWWWWWWWWWWWWWWWWWWWWWWWWWWWWW
VVVVVVVVVVVVVVVVVVVVVVVVVVVVVV<AAAAAAAAAAAAAA123AAAAAAAA>WWWWWWWWWWWWWWWWWWWWWWWWWWWWWW
VVVVVVVVVVVVVVVVVVVVVVVVVVVVVV<AAAAAAAAAAAAAA894AAAAAAAA>WWWWWWWWWWWWWWWWWWWWWWWWWWWWWW
VVVVVVVVVVVVVVVVVVVVVVVVVVVVVV<AAAAAAAAAAAAAA894AAAAAAAA>WWWWWWWWWWWWWWWWWWWWWWWWWWWWWW
VVVVVVVVVVVVVVVVVVVVVVVVVVVVVV<AAAAACAAAAAAAA894AAAAAAAA>WWWWWWWWWWWWWWWWWWWWWWWWWWWWWW
VVVVVVVVVVVVVVVVVVVVVVVVVVVVVV<AAAAAAAAAAAAAA894AAAAAAAA>WWWWWWWWWWWWWWWWWWWWWWWWWWWWWW
VVVVVVVVVVVVVVVVVVVVVVVVVVVVVV<AAAAAAAAAAAAAA894AAAAAAAA>WWWWWWWWWWWWWWWWWWWWWWWWWWWWWW
VVVVVVVVVVVVVVVVVVVVVVVVVVVVVV<AAAAAAAAAAAAAA894AAAAAAAA>WWWWWWWWWWWWWWWWWWWWWWWWWWWWWW
VVVVVVVVVVVVVVVVVVVVVVVVVVVVVV<AAAAAAAAAAAAAA894AAAAAAAA>WWWWWWWWWWWWWWWWWWWWWWWWWWWWWW
VVVVVVVVVVVVVVVVVVVVVVVVVVVVVV<AAAAAAAAAAAAAA894AAAAAAAA>WWWWWWWWWWWWWWWWWWWWWWWWWWWWWW
VVVVVVVVVVVVVVVVVVVVVVVVVVVVVV<AAAAABBBBBAAAA89922223AAA>WWWWWWWWWWWWWWWWWWWWWWWWWWWWWW
VVVVVVVVVVVVVVVVVVVVVVVVVVVVVV<AAAAABBBBBAAAA89999994AAA>WWWWWWWWWWWWWWWWWWWWWWWWWWWWWW
VVVVVVVVVVVVVVVVVVVVVVVVVVVVVV<AAABBBBBAAAABA76666994AAA>WWWWWWWWWWWWWWWWWWWWWWWWWWWWWW
VVVVVVVVVVVVVVVVVVVVVVVVVVVVVV<AAABBBBBATAAAAAAAAA89923A>WWWWWWWWWWWWWWWWWWWWWWWWWWWWWW
VVVVVVVVVVVVVVVVVVVVVVVVVVVVVV<AAAAAAAAAAAAAAAAAAA89994A>WWWWWWWWWWWWWWWWWWWWWWWWWWWWWW
VVVVVVVVVVVVVVVVVVVVVVVVVVVVVV<AAAAAAAAAAAAAAAAAAA76665A>WWWWWWWWWWWWWWWWWWWWWWWWWWWWWW
VVVVVVVVVVVVVVVVVVVVVVVVVVVVVV<AAAAAAAATAAAAAAAAAAAAAAAA>WWWWWWWWWWWWWWWWWWWWWWWWWWWWWW
VVVVVVVVVVVVVVVVVVVVVVVVVVVVVV<AAAAAAAAAAAAAAAAAAAAAAAAA>WWWWWWWWWWWWWWWWWWWWWWWWWWWWWW
VVVVVVVVVVVVVVVVVVVVVVVVVVVVVV<AAAAAAAAAAAAAAAAAAAAAAAAA>WWWWWWWWWWWWWWWWWWWWWWWWWWWWWW
VVVVVVVVVVVVVVVVVVVVVVVVVVVVVV<AAAAAAAAAAAAAAAAAAAAAAAAA>WWWWWWWWWWWWWWWWWWWWWWWWWWWWWW
VVVVVVVVVVVVVVVVVVVVVVVVVVVVVV<AAAAAAAAAAAAAAAAAAAAAAAAA>WWWWWWWWWWWWWWWWWWWWWWWWWWWWWW
VVVVVVVVVVVVVVVVVVVVVVVVVVVVVV<AAAAAAAAAAAAAAAAAAAAAAAAA>WWWWWWWWWWWWWWWWWWWWWWWWWWWWWW
VVVVVVVVVVVVVVVVVVVVVVVVVVVVVV<TTTTTTTTTTTTTTTTTTTTTTTTT>WWWWWWWWWWWWWWWWWWWWWWWWWWWWWW
VVVVVVVVVVVVVVVVVVVVVVVVVVVVVV<AAAAAAAAAAAAAAAAAAAAAAAAA>WWWWWWWWWWWWWWWWWWWWWWWWWWWWWW
VVVVVVVVVVVVVVVVVVVVVVVVVVVVVV<AAAAAAAAAAAAAAAAAAAAAAAAA>WWWWWWWWWWWWWWWWWWWWWWWWWWWWWW
VVVVVVVVVVVVVVVVVVVVVVVVVVVVVV<AAAAAAAAAAAAAAAAAAAAAAAAA>WWWWWWWWWWWWWWWWWWWWWWWWWWWWWW
VVVVVVVVVVVVVVVVVVVVVVVVVVVVVV<AAAAAAAAAAAAAAAAAAAAAAAAA>WWWWWWWWWWWWWWWWWWWWWWWWWWWWWW
VVVVVVVVVVVVVVVVVVVVVVVVVVVVVV<AAAAAAAAAAAAAAAAAAAAAAAAA>WWWWWWWWWWWWWWWWWWWWWWWWWWWWWW
VVVVVVVVVVVVVVVVVVVVVVVVVVVVVV<AAAAAAAAAAAAAAAAAAAAAAAAA>WWWWWWWWWWWWWWWWWWWWWWWWWWWWWW
VVVVVVVVVVVVVVVVVVVVVVVVVVVVVV<AAAAAAAAAAAAAAAAAAAAAAAAA>WWWWWWWWWWWWWWWWWWWWWWWWWWWWWW
VVVVVVVVVVVVVVVVVVVVVVVVVVVVVV<AAAAAAAAAAAAAAAAAAAAAAAAA>WWWWWWWWWWWWWWWWWWWWWWWWWWWWWW
VVVVVVVVVVVVVVVVVVVVVVVVVVVVVV<AAAAAAAAAAAAAAAAAAAAAAAAA>WWWWWWWWWWWWWWWWWWWWWWWWWWWWWW
VVVVVVVVVVVVVVVVVVVVVVVVVVVVVV<AAAAAAAAAAAAAAAAAAAAAAAAA>WWWWWWWWWWWWWWWWWWWWWWWWWWWWWW
VVVVVVVVVVVVVVVVVVVVVVVVVVVVVV<AAAAAAAAAAAAAAAAAAAAAAAAA>WWWWWWWWWWWWWWWWWWWWWWWWWWWWWW
VVVVVVVVVVVVVVVVVVVVVVVVVVVVVV<AAAAAAAAAAAAAAAAAAAAAAAAA>WWWWWWWWWWWWWWWWWWWWWWWWWWWWWW
VVVVVVVVVVVVVVVVVVVVVVVVVVVVVV<AAAAAAAAAAAAAAAAAAAAAAAAA>WWWWWWWWWWWWWWWWWWWWWWWWWWWWWW
VVVVVVVVVVVVVVVVVVVVVVVVVVVVVV<AAAAAAAAAAAAAAAAAAAAAAAAA>WWWWWWWWWWWWWWWWWWWWWWWWWWWWWW
VVVVVVVVVVVVVVVVVVVVVVVVVVVVVV<AAAAAAAAAAAAAAAAAAAAAAAAA>WWWWWWWWWWWWWWWWWWWWWWWWWWWWWW
VVVVVVVVVVVVVVVVVVVVVVVVVVVVVV<AAAAAAAAAAAAAAAAAAAAAAAAA>WWWWWWWWWWWWWWWWWWWWWWWWWWWWWW
XXXXXXXXXXXXXXXXXXXXXXXXXXXXXXXXXXXXXXXXXXXXXXXXXXXXXXXXXXXXXXXXXXXXXXXXXXXXXXXXXXXXXXX