XXXXXXXXXXXXXXXXXXXXXXXXXXXXXXXXXXXXXXXXXXXXX
VVVVVVVV<AAAAAAAAAAAAAA894AAAAAAAA>WWWWWWWWWW
VVVVVVVV<AAAAAAAAAAAAAA894AAAAAAAA>WWWWWWWWWW
VVVVVVVV<AAAAAAAAAAAAAA894AAAAAAAA>WWWWWWWWWW
VVVVVVVV<AAAAAAAAAAAAAA894AAAAAAAA>WWWWWWWWWW
VVVVVVVV<AAAAAAAAAAAAAA894AAAAAAAA>WWWWWWWWWW
VVVVVVVV<AAAAAAAAAAAAAA894AAAAAAAA>WWWWWWWWWW
VVVVVVVV<AAAAAAAAAAAAAA894AAAAAAAA>WWWWWWWWWW
VVVVVVVV<AAAAAAAAAAAAAA894AAAAAAAA>WWWWWWWWWW
VVVVVVVV<AAAAAAAAAAAAAA894AAAAAAAA>WWWWWWWWWW
VVVVVVVV<AAAAABBBBBAAAA89922223AAA>WWWWWWWWWW
VVVVVVVV<AAAAABBBBBAAAA89999994AAA>WWWWWWWWWW
VVVVVVVV<AAABBBBBAAAABA76666994AAA>WWWWWWWWWW
VVVVVVVV<AAABBBBBATAAAAAAAAA89923A>WWWWWWWWWW
VVVVVVVV<AAAAAAAAAAAAAAAAAAA89994A>WWWWWWWWWW
VVVVVVVV<AAAAAAAAAAAAAAAAAAA76665A>WWWWWWWWWW
VVVVVVVV<AAAAAAAATAAAAAAAAAAAAAAAA>WWWWWWWWWW
VVVVVVVV<AAAAAAAAAAAAAAAAAAAAAAAAA>WWWWWWWWWW
VVVVVVVV<AAAAAAAAAAAAAAAAAAAAAAAAA>WWWWWWWWWW
VVVVVVVV<AAAAAAAAAAAAAAAAAAAAAAAAA>WWWWWWWWWW
VVVVVVVV<AAAAAAAAAAAAAAAAAAAAAAAAA>WWWWWWWWWW
VVVVVVVV<AAAAAAAAAAAAAAAAAAAAAAAAA>WWWWWWWWWW
XXXXXXXXXXXXXXXXXXXXXXXXXXXXXXXXXXXXXXXXXXXXX